{
    "boards": {
        "😎P": "B",
        "😎Q": "F",
        "😎R": "C",
        "😎S": "G",
        "😎T": "E",
        "😎U": "C",
        "🇲🇺P": "A",
        "🇲🇺Q": "C",
        "🇲🇺R": "A",
        "🇲🇺S": "C",
        "🇲🇺T": "C",
        "🇲🇺U": "A",
        "🍪P": "A",
        "🍪Q": "F",
        "🍪R": "B",
        "🍪S": "H",
        "🍪T": "A",
        "🍪U": "D",
        "💖P": "G",
        "💖Q": "A",
        "💖R": "H",
        "💖S": "H",
        "💖T": "F",
        "💖U": "B",
        "⚡P": "B",
        "⚡Q": "A",
        "⚡R": "A",
        "⚡S": "F",
        "⚡T": "H",
        "⚡U": "C",
        "🌵P": "E",
        "🌵Q": "H",
        "🌵R": "G",
        "🌵S": "H",
        "🌵T": "D",
        "🌵U": "F",
        "🌱P": "B",
        "🌱Q": "E",
        "🌱R": "G",
        "🌱S": "G",
        "🌱T": "H",
        "🌱U": "G",
        "🐑P": "H",
        "🐑Q": "A",
        "🐑R": "D",
        "🐑S": "B",
        "🐑T": "D",
        "🐑U": "A",
        "🥯P": "A",
        "🥯Q": "E",
        "🥯R": "G",
        "🥯S": "D",
        "🥯T": "F",
        "🥯U": "B",
    },
    "missing": [
        "🧀",
        "🌙",
        "🦋",
        "👻",
        "🧩",
        "🐀",
        "🐍",
        "♾️",
        "⚽",
        "🏝️",
        "📚",
        "🍌",
        "🐺",
        "🍕",
        "🍔",
        "🐦‍🔥",
        "🎈",
        "🤠",
        "🐉",
        "⛰️",
        "🤖"
    ]
}
